24 25 30 24 25 30 24 25 30 24 25 30 24 25 23 24 25 30 24 25 30 24 25 23 24 25 30 24 25 30 24 25 30 24 25 23 24 25 30 24 25 30 24 25 30 24 25 23 24 25 30 24 25 30 24 25 23
26 27 23 26 27 23 26 27 30 26 27 30 26 27 30 26 27 30 26 27 30 26 27 30 26 27 23 26 27 23 26 27 30 26 27 30 26 27 23 26 27 23 26 27 30 26 27 30 26 27 23 26 27 23 26 27 30
28 29 30 28 29 23 28 29 30 28 29 30 28 29 30 28 29 30 28 29 23 28 29 23 28 29 30 28 29 30 28 29 23 28 29 23 28 29 30 28 29 30 28 29 23 28 29 23 28 29 30 28 29 30 28 29 30
24 25 30 24 25 30 24 25 30 24 25 23 24 25 23 24 25 23 24 25 30 24 25 23 24 25 30 24 25 30 24 25 30 24 25 23 24 25 30 24 25 30 24 25 30 24 25 23 24 25 30 24 25 30 24 25 23
26 27 30 26 27 23 26 27 30 26 27 30 26 27 30 26 27 23 26 27 30 26 27 30 26 27 23 26 27 23 26 27 30 26 27 30 26 27 23 26 27 23 26 27 30 26 27 30 26 27 23 26 27 23 26 27 30
28 29 23 28 29 30 28 29 23 28 29 30 28 29 30 28 29 23 28 29 23 28 29 23 28 29 30 28 29 30 28 29 23 28 29 23 28 29 30 28 29 30 28 29 23 28 29 23 28 29 30 28 29 30 28 29 23
24 25 30 24 25 30 24 25 30 24 25 30 24 25 30 24 25 30 30 30 30 30 30 30 30 30 30 24 25 30 24 25 30 30 37 40 40 40 40 36 30 30 24 25 30 24 25 23 24 25 30 24 25 30 24 25 23
26 27 30 26 27 30 26 27 23 26 27 23 26 27 23 26 27 30 30 30 30 30 30 30 30 30 30 26 27 23 26 27 30 37 33 31 31 31 31 35 36 23 26 27 30 26 27 30 26 27 23 26 27 23 26 27 23
28 29 30 28 29 30 28 29 23 28 29 23 28 29 23 28 29 30 30 30 30 30 30 30 30 30 30 28 29 23 28 29 37 33 31 31 31 31 31 31 35 36 28 29 23 28 29 23 28 29 30 28 29 30 28 29 30
24 25 30 24 25 23 24 25 30 30 30 30 30 30 30 24 25 30 30 30 30 30 30 15 19 19 19 19 16 37 40 40 33 31 31 31 31 31 31 31 31 42 30 23 30 24 25 30 24 25 23 24 25 30 24 25 30
26 27 23 26 27 23 26 27 30 30 30 30 30 30 30 26 27 30 30 30 30 30 30 22 10 10 10 10 21 44 45 45 46 31 31 31 31 31 31 31 31 35 36 23 23 26 27 30 26 27 30 26 27 23 26 27 23
28 29 30 28 29 23 28 29 30 30 30 30 30 30 30 28 29 30 30 30 30 30 30 22 10 11 20 20 17 41 31 31 31 31 31 31 31 31 34 43 43 32 35 36 30 28 29 23 28 29 23 28 29 30 28 29 30
24 25 23 24 25 23 24 25 30 30 30 30 24 25 23 24 25 30 30 30 30 30 30 22 10 21 23 24 25 39 43 43 43 32 31 31 31 34 38 24 25 39 32 35 36 30 37 40 40 36 37 40 40 36 37 40 40
26 27 23 26 27 30 26 47 30 30 30 30 48 27 23 26 27 30 30 30 30 30 30 22 10 21 23 26 27 23 23 24 25 39 43 43 43 38 23 26 27 23 39 32 35 40 33 34 32 35 33 34 32 35 33 34 32
28 29 30 28 29 30 28 29 30 30 30 30 28 29 23 28 29 30 15 19 19 19 19 14 10 21 23 28 29 24 25 26 27 23 24 25 23 24 25 28 29 24 25 39 32 31 34 38 39 43 43 38 39 43 43 38 39
24 25 30 24 25 30 24 25 30 30 30 30 24 25 15 19 19 19 14 10 10 10 10 10 10 21 23 24 25 26 27 28 29 23 26 27 23 26 27 23 23 26 27 23 39 43 38 24 25 23 30 24 25 30 24 25 30
26 27 30 26 27 30 26 47 30 30 30 30 48 27 22 10 10 10 10 11 20 20 20 20 20 17 23 26 27 28 29 15 19 16 28 29 23 28 29 15 16 28 29 24 25 23 23 26 27 24 25 26 27 30 26 27 30
28 29 23 28 29 30 28 29 30 30 30 30 28 29 22 10 11 20 20 17 24 25 23 23 23 23 23 28 29 15 19 14 10 13 19 19 19 19 19 14 13 19 16 26 27 24 25 28 29 26 27 28 29 23 28 29 23
24 25 23 24 25 30 24 25 30 30 30 30 24 25 22 10 21 23 23 23 26 27 30 30 23 23 15 19 19 14 10 10 10 10 10 10 10 10 10 10 10 10 21 28 29 26 27 24 25 28 29 24 25 30 24 25 30
26 27 30 26 27 23 26 47 30 30 30 30 48 27 22 10 21 23 23 23 28 29 23 23 15 19 14 10 10 10 10 10 10 10 10 10 10 10 10 10 10 10 13 19 16 28 29 26 27 24 25 26 27 30 26 27 23
28 29 30 28 29 23 28 29 30 30 30 30 28 29 22 10 13 19 19 19 16 30 30 15 14 10 10 10 10 10 10 10 10 10 10 10 10 10 10 10 10 10 10 10 13 19 16 28 29 26 27 28 29 30 28 29 30
24 25 30 24 25 15 19 19 19 19 19 19 19 19 14 10 10 10 10 10 13 19 19 14 10 10 10 10 10 10 10 10 10 10 10 10 10 10 10 10 10 10 10 10 10 10 21 24 25 28 29 24 25 30 24 25 30
26 27 23 26 27 22 10 10 10 10 10 10 10 10 10 10 10 10 10 10 10 10 10 10 10 10 10 10 10 10 10 10 10 10 10 10 10 10 10 10 10 10 10 10 10 10 21 26 27 24 25 26 27 30 26 27 23
28 29 30 28 29 22 10 10 10 10 10 10 10 10 11 20 20 20 20 12 10 10 10 10 11 20 12 10 11 20 20 20 20 20 20 20 20 12 10 10 10 10 10 10 10 10 21 28 29 26 27 28 29 30 28 29 30
24 25 23 24 25 18 20 20 20 12 10 10 11 20 17 24 25 23 23 18 20 20 20 20 17 23 18 20 17 24 25 23 24 25 23 24 25 18 20 12 10 10 10 10 10 10 21 24 25 28 29 24 25 30 24 25 30
26 27 30 26 27 24 25 23 23 22 10 10 21 23 30 26 27 24 25 23 24 25 23 24 25 23 23 24 25 26 27 30 26 27 30 26 27 24 25 18 20 12 10 10 11 20 17 26 27 24 25 26 27 30 26 27 23
28 29 30 28 29 26 27 24 25 22 10 10 21 24 25 28 29 26 27 30 26 27 30 26 27 24 25 26 27 28 29 23 28 29 23 28 29 26 27 24 25 18 20 20 17 24 25 28 29 26 27 28 29 30 28 29 30
24 25 30 24 25 28 29 26 27 22 10 10 21 26 27 30 30 28 29 23 28 29 30 28 29 26 27 28 29 15 19 19 19 19 19 19 16 28 29 26 27 23 23 24 25 26 27 24 25 28 29 24 25 30 24 25 30
26 27 30 26 27 24 25 28 29 22 10 10 21 28 29 30 23 30 30 30 23 30 23 30 30 28 29 15 19 14 10 10 10 10 10 10 13 19 16 28 29 24 25 26 27 28 29 26 27 24 25 26 27 30 26 27 23
28 29 30 28 29 26 27 24 25 22 10 10 21 23 24 25 30 23 30 23 30 30 24 25 23 15 19 14 10 10 10 10 10 10 10 10 10 10 13 16 23 26 27 28 29 30 30 28 29 26 27 28 29 30 28 29 30
24 25 30 24 25 28 29 26 27 22 10 10 13 16 26 27 30 30 23 30 23 30 26 27 15 14 10 10 10 11 20 20 20 20 20 12 10 10 10 21 23 28 29 30 24 25 30 30 30 28 29 24 25 30 24 25 30
26 27 23 26 27 24 25 28 29 22 10 10 10 21 28 29 30 23 23 30 30 30 28 29 22 10 10 11 20 17 24 25 23 24 25 18 20 12 10 13 16 23 30 30 26 27 24 25 30 24 25 26 27 30 26 27 23
28 29 30 28 29 26 27 24 25 18 12 10 10 13 16 24 25 30 30 23 23 24 25 23 22 10 10 21 24 25 26 27 30 26 27 24 25 22 10 10 21 23 24 25 28 29 26 27 30 26 27 28 29 30 28 29 30
24 25 30 24 25 28 29 26 27 23 18 12 10 10 21 26 27 30 23 24 25 26 27 15 14 10 10 21 26 27 28 29 23 28 29 26 27 22 10 10 13 16 26 27 24 25 28 29 23 28 29 24 25 30 24 25 30
26 27 30 26 27 24 25 28 29 24 25 22 10 10 21 28 29 24 25 26 27 28 29 22 10 10 11 17 28 29 37 40 40 40 36 28 29 18 12 10 10 21 28 29 26 27 15 19 19 16 30 26 27 30 26 27 23
28 29 30 28 29 26 27 24 25 26 27 22 10 10 13 19 16 26 27 28 29 15 19 14 10 10 21 24 25 37 33 31 31 31 35 36 24 25 22 10 10 21 23 23 28 29 22 10 10 21 30 28 29 30 28 29 30
24 25 23 24 25 28 29 26 27 28 29 18 12 10 10 10 21 28 29 15 19 14 10 10 10 10 21 26 27 41 31 31 31 31 31 42 26 27 22 10 10 13 19 19 19 19 14 10 10 21 30 24 25 30 24 25 30
26 27 23 26 27 24 25 28 29 24 25 23 18 12 10 10 13 16 23 22 10 10 10 11 20 20 17 28 29 41 31 31 31 31 31 42 28 29 22 10 10 10 10 10 10 10 10 10 10 21 30 26 27 30 26 27 23
28 29 30 28 29 26 27 24 25 26 27 24 25 22 10 10 10 13 19 14 10 10 11 17 37 40 40 40 40 33 31 31 31 31 31 42 24 25 22 10 10 10 10 10 10 10 11 20 20 17 30 28 29 30 28 29 30
24 25 30 24 25 28 29 26 27 28 29 26 27 18 12 10 10 10 10 10 10 10 21 30 44 45 45 45 46 31 31 31 31 31 31 42 26 27 22 10 10 11 20 20 20 20 17 24 25 23 23 24 25 30 24 25 30
26 27 30 26 27 24 25 28 29 24 25 28 29 23 18 20 12 10 10 10 10 10 13 16 39 43 43 43 43 32 31 31 31 31 34 38 28 29 22 10 10 21 23 23 23 24 25 26 27 24 25 26 27 30 26 27 23
28 29 30 28 29 26 27 24 25 26 27 24 25 23 23 23 18 20 20 12 10 10 10 13 19 19 16 24 25 41 31 31 31 34 38 24 25 15 14 10 10 21 23 24 25 26 27 28 29 26 27 28 29 30 28 29 30
24 25 30 24 25 28 29 26 27 28 29 26 27 24 25 23 23 23 23 18 20 12 10 10 10 10 21 26 27 39 43 43 43 38 23 26 27 22 10 10 11 17 23 26 27 28 29 24 25 28 29 24 25 30 24 25 30
26 27 23 26 27 23 23 28 29 24 25 28 29 26 27 24 25 23 23 23 23 22 10 10 10 10 21 28 29 24 25 23 30 24 25 28 29 22 10 10 21 24 25 28 29 24 25 26 27 24 25 26 27 30 26 27 23
28 29 23 28 29 23 37 36 30 26 27 23 23 28 29 26 27 24 25 30 23 18 20 12 10 10 13 16 30 26 27 24 25 26 27 15 19 14 10 11 17 26 27 24 25 26 27 28 29 26 27 28 29 30 28 29 30
24 25 23 24 25 37 33 35 36 28 29 37 40 40 36 28 29 26 27 30 23 23 23 18 12 10 10 21 30 28 29 26 27 28 29 22 10 10 10 21 23 28 29 26 27 28 29 23 23 28 29 24 25 30 24 25 30
26 27 30 26 27 41 31 31 35 40 40 33 31 31 35 36 23 28 29 30 23 23 23 23 22 10 10 13 19 19 16 28 29 15 19 14 10 10 10 21 23 23 23 28 29 23 15 19 16 24 25 26 27 30 26 27 23
28 29 30 28 29 41 31 31 31 31 31 31 31 34 43 38 24 25 23 23 15 19 19 19 14 10 10 10 10 10 13 19 19 14 10 10 10 10 10 13 19 19 16 23 15 19 14 10 21 26 27 28 29 30 28 29 30
24 25 30 24 25 41 31 31 31 31 31 31 31 42 24 25 26 27 15 19 14 10 10 10 10 10 10 10 10 10 10 10 10 10 10 11 20 12 10 10 10 10 13 19 14 10 10 11 17 28 29 24 25 30 24 25 30
26 27 23 26 27 39 32 31 31 31 31 31 34 38 26 27 28 29 22 10 10 10 10 10 11 20 20 20 20 12 10 10 10 10 11 17 23 18 20 20 12 10 10 10 10 11 20 17 23 23 30 26 27 30 26 27 23
28 29 23 28 29 23 39 43 43 43 43 43 38 23 28 29 23 23 18 20 20 20 20 20 17 23 23 23 23 18 20 20 20 20 17 23 30 23 23 23 18 20 20 20 20 17 23 23 30 30 23 28 29 30 28 29 30
24 25 23 24 25 23 24 25 23 24 25 23 24 25 30 24 25 23 24 25 23 24 25 23 24 25 23 24 25 23 24 25 23 24 25 23 24 25 23 24 25 23 24 25 23 24 25 23 24 25 23 24 25 23 24 25 23
26 27 30 26 27 30 26 27 30 26 27 23 26 27 30 26 27 23 26 27 23 26 27 30 26 27 23 26 27 30 26 27 23 26 27 30 26 27 23 26 27 30 26 27 23 26 27 30 26 27 23 26 27 30 26 27 30
28 29 30 28 29 30 28 29 30 28 29 23 28 29 30 28 29 30 28 29 30 28 29 30 28 29 30 28 29 30 28 29 30 28 29 30 28 29 30 28 29 30 28 29 30 28 29 30 28 29 30 28 29 30 28 29 30
24 25 30 24 25 23 24 25 30 24 25 30 24 25 30 24 25 30 24 25 30 24 25 30 24 25 23 24 25 23 24 25 23 24 25 23 24 25 23 24 25 23 24 25 23 24 25 23 24 25 23 24 25 23 24 25 23
26 27 30 26 27 30 26 27 30 26 27 30 26 27 23 26 27 30 26 27 30 26 27 30 26 27 23 26 27 30 26 27 23 26 27 30 26 27 23 26 27 30 26 27 23 26 27 30 26 27 23 26 27 30 26 27 23
28 29 30 28 29 23 28 29 30 28 29 30 28 29 23 28 29 23 28 29 30 28 29 30 28 29 30 28 29 23 28 29 30 28 29 30 28 29 30 28 29 30 28 29 30 28 29 30 28 29 30 28 29 30 28 29 30